UNIPROT_SEQ_NUM	UNIPROT	PDBResNumAuthor
1510	Q	1510
1511	L	1511
1512	V	1512
1513	T	1513
1514	S	1514
1515	L	1515
