UNIPROT_SEQ_NUM	UNIPROT	PDBResNumAuthor
1149	R	1148
1150	P	1149
1151	P	1150
1152	D	1151
1153	L	1152
1154	W	1153
1155	I	1154
1156	H	1155
