UNIPROT_SEQ_NUM	UNIPROT	PDBResNumAuthor	PDBResNumCIF
1510	Q	1510	2
1511	L	1511	3
1512	V	1512	4
1513	T	1513	5
1514	S	1514	6
1515	L	1515	7
