UNIPROT_SEQ_NUM	UNIPROT	PDBResNumAuthor	PDBResNumCIF
450	N	1	1
451	P	2	2
452	R	3	3
453	A	4	4
454	M	5	5
455	Q	6	6
456	A	7	7
457	L	8	8
458	L	9	9
